湣	erpa
澡	errd
潬	errj
湂	errs
澏	erru
溊	erse
湒	ersj
汜	eru
潠	eruc
洖	ervk
泯	ervp
澠	erxu
浞	eryo
汇	es
涮	esbn
澱	esce
渠	esd
灟	esei
漽	eseq
沼	eshr
浘	eshu
澀	esim
涩	esim
涊	esip
濫	esit
洱	esj
潳	esja
滠	esje
灄	esjj
涺	esjr
沤	esk	es'k
泦	eskn
涒	eskr
洍	esll	es'll
瀶	eslr
汈	esm
漝	esma
漏	esmb
瀥	esmb
瀷	esmc
浸	esme
濯	esmg
洭	esmg	es'mg
渥	esmg
漻	esmh
潯	esmi
浔	esmi
濢	esmj
瀈	esmj
泀	esmr
濫	esmt
涱	esmv
潺	esnd
沢	eso
滙	esog	es'og
浕	esoy
泥	esp
溤	esqf
澼	esrj
漚	esrr	es'rr
洰	ess
氾	esu
淈	esuu
灠	eswu
濗	etab
漠	etak
灡	etaw
淟	etbc
溁	etbd
潆	etbf
滢	etbi
潵	etbk
湔	etbn
濛	etbo
涝	etbs
洪	etc
潽	etca
澲	etcd
灇	etce
濝	etcf
澌	etcl
溢	etct
港	etcu
湭	etcw
漾	etge
溔	etgf
濧	etgi
渼	etgk
湵	etgo
濭	etgt
渞	ethu
瀳	etif
漭	etit
滞	etjb
浂	etk
渕	etkn
渃	etkr
滿	etlb
潢	etlc
渶	etlk
