𡟈	vhju
𡟢	vhju
𡜘	vhjv
𡞊	vhkf
𡟡	vhkj
𡢭	vhkm
𡟥	vhlb
𢀟	vhm
𡢒	vhmt
𡜮	vhmu
𡛴	vhmy
𡚫	vhn
𤕋	vhnba
𡚾	vhne
𡠨	vhnh
𨙵	vhnl
𡠞	vhoi
𡤷	vhom
𡛜	vhpm
𡜞	vhpp
𡜶	vhpr
𡟪	vhrb
𡠄	vhrf
𡜥	vhrr
𡝢	vhsk
𡞬	vhsk
𡛈	vht
𨜕	vhtcl
𠃔	vhu
𡠖	vhuj
𡛜	vhvi
𠬳	vhvie
𡚼	vhvp
𡜧	vhwk
𡠌	vhwp
𡠴	vhwp
𡟉	vhwu
𡞭	vhxb
𡤚	vhxf
𡞄	vhxs
𡞲	vhxs
𡤞	vhxu
𡞉	vhxv
𡟦	vhyl
𡛏	vi
𡚦	vi
𡜗	via
𣌳	via
𤖛	vibm
𡜫	viby
𨫥	vic
𢇃	vicc
𡣥	vidv
𢆼	vie
𢇄	viefh
𡤗	vif
𢇁	vif
𤍵	vif
𢆷	vifh
𡤠	vift
𧽩	vigyo
𪈿	vihaf
𧗇	vihbt
𡟬	vihf
𡠽	vihf
𡣴	vihf
𡜐	vihi
𡞖	vihm
𠙝	vihn
𢆻	vihn
𤯖	vihqm
𧗒	viht
𩴆	vihui
𩴪	vihui
𡠐	viij
𢆴	viilv
𡜵	vijb
𡣤	vijbj
𡗞	vik
𢇈	vikc
𡞋	vikh
𡣇	vikp
𢆲	viks
𩑴	viksc
𣢜	vikso
𧗒	vikt
𢆯	vil
𧖀	vilii
𧎶	vilmi
𠟣	viln
𠠞	viln
𩑗	vimbc
𨍃	vimjj
𢆹	vimmi
𠒴	vimmu
𩱑	vimrb
𢨂	vimym
𢇐	vinao
𡥝	vind
𡛻	vine
