潇	etll
漌	etlm
漢	etlo
瀟	etlx
泔	etm	et'm
满	etmb
頮	etmbc
颒	etmbo
淇	etmc
湈	etmd
澕	etmj
渮	etmr
湛	etmv
濩	etoe
灘	etog
溚	etor
濸	etor
瀁	etov
濍	etpp
洋	etq
溠	etqm
灌	etrg
灆	etst
洴	ett
汫	ett
溝	ettb
湴	ettc
渆	ettn
灎	ettt
灔	ettu
溯	etub
満	etub
溬	etui
滋	etvi
濨	etvp
浀	etw
渵	etw
漕	etwa
澫	etwb
瀎	etwi
澊	etwi
澧	etwt
濃	etwv
溓	etxc
淽	etym
淓	etys
汕	eu
潉	euap
漰	eubb
鎏	euc
鍌	euc
澂	eugk
溄	euhq
漴	eujf
灃	eujt
汹	euk	eu'k
湠	eukf
湍	eumb
湠	eumf
漄	eumg
瑬	eumgi
滍	eumi
溰	eumt
涵	eune	eu'ne
溦	eunk
漼	euog
涔	euon
潂	eutc
灩	eutt
灧	eutu
泏	euu
溦	euuk
汝	ev
灤	evfd
濰	evfg
灣	evfn
濼	evid
泤	evio
泑	evis
潍	evmg
湽	evmw
淥	evne
湪	evno
洳	evr
灉	evug
漅	evvd
淄	evvw
沺	ew
畓	ew
渭	ewb
泗	ewc	ew'c
溭	ewce
淉	ewd
涃	ewd	ew'd
潿	ewdq	ew'dq
溿	ewfq
浬	ewg
潶	ewgf
濹	ewgg
漍	ewim	ew'im
