鐳	cmbw
釪	cmd
銾	cme
鈈	cmf
鑈	cmfb
鋄	cmfe
錽	cmfe
銔	cmfj
鉟	cmfm
錱	cmgg
鈺	cmgi
鑩	cmgr
鶲	cmhaf
鋣	cmhl
銍	cmig
釬	cmj
銒	cmjj
勜	cmks
錏	cmlm
鐂	cmlw
銢	cmme
鐚	cmmp
鋙	cmmr
釫	cmms
鈨	cmmu
鋠	cmmv
釘	cmn
鈳	cmnr
鈵	cmob
憌	cmp
錻	cmpm
鹟	cmpym
鉐	cmr
鎘	cmrb
鎶	cmrr
鋀	cmrt
鍢	cmrw
鈪	cmsu
鈃	cmt
鉶	cmtn
鐝	cmto
鐕	cmua
釾	cmvh
鎒	cmvi
鋞	cmvm
兮	cmvs
鏢	cmwf
鐔	cmwj
鉦	cmym
鈣	cmys
釔	cn
鐌	cnao
銫	cnau
鋔	cnau
釨	cnd
錳	cndt
鉨	cnf
鈕	cng
鐍	cnhb
鍒	cnhd
鈒	cnhe
釢	cnhs
錎	cnhx
釸	cni	cn'i
銿	cnib
鏹	cnii
鉹	cnin
銘	cnir
鋌	cnkg
鋋	cnkm
鍵	cnkq
鈏	cnl
弚	cnl
鈟	cnl
弟	cnlh
鐊	cnlh
錒	cnlr
録	cnme
釕	cnn
欽	cno
鏺	cnoe
鍨	cnok
鐙	cnot
鑱	cnri
鏹	cnri
錚	cnsd
鑥	cnwa
釞	co
鍑	coae
鈉	cob
銝	cod
鉜	codi
鉩	cof
錐	cog
鏶	cogd
鐎	cogf
鎨	cogj
鐫	cogs
鎸	cogs
銋	cohg
