岧	ushr
岹	ushr
崌	usjr
岖	usk	us'k
峮	uskr
嶍	usma
嵺	usmh
嶇	usrr	us'rr
岠	uss
岂	usu
屺	usu
崛	usuu
崫	usuu
嶱	utav
嵘	utbd
崂	utbs
覬	utbuu
嶪	utcd
嶫	utcd
巙	utce
豒	utcnh
崷	utcw
嶬	utgi
豔	utgit
嵄	utgk
凱	uthn
颽	uthni	uthn'i
巕	uthv
獃	utik
巈	utjd
豓	utkit
剴	utln
顗	utmbc
嵌	utmo
嵁	utmv
艷	utnau
酆	utnl
敳	utok
嵯	utqm
嵳	utqm
巏	utrg
嵫	utvi
嶆	utwa
嶟	utwi
嶩	utwv
嵰	utxc
敱	utye
出	uu
艸	uu
屾	uu
岀	uu
乢	uu
觊	uubhu
嵕	uuce
嵏	uuce
粜	uufd
凯	uuhn
剀	uuln
祟	uummf
嵦	uumt
崡	uune	uu'ne
欪	uuno
芔	uuu
茻	uuuu
幽	uvii	u'vii
岰	uvis
嶈	uvmi
崰	uvvw
崓	uwjr	uw'jr
崮	uwjr	uw'jr
岬	uwl
嵎	uwlb
嶧	uwlj
嶵	uwly
嵔	uwmv
崽	uwp
峕	uya
崹	uybb
巘	uybk
巚	uybk
巃	uybp
巄	uybp
嵭	uybs
巐	uybt
峧	uyck
嵃	uyhh
嵼	uyhm
嵃	uykh
嵼	uykm
訔	uymr
峠	uymy
崒	uyoj
崪	uyoj
岾	uyr
嵩	uyrb
嵪	uyrb
崞	uyrd
嵉	uyrn
崺	uysd
屿	uysm
