䚆	tkbuu
䓭	tkcn
䓭	tkdn
䔆	tkhg
䓄	tkhl
㲟	tkhqu
䒝	tkk
䔪	tkkk
䓫	tkmr
㽀	tkmvn
䣐	tknl
䓐	tkpu
㢣	tkt
䕣	tlav
䒥	tlb
㒼	tlbo
䓣	tlbo
䒞	tlbu
䔥	tlll
㽄	tlmvn
㬫	tlpa
㷼	tlpf
䒶	tlwp
䕁	tlyd
㐀	tm
䔈	tmbc
䓴	tmbk
䖅	tmbo
㿷	tmdhe
㝻	tmfh
䕯	tmfo
䓏	tmfr
䔷	tmgn
䔊	tmgt
䲺	tmhaf
䓉	tmhl
䡨	tmjwj
䗣	tmlii
䒬	tmmf
䕻	tmmp
䓊	tmmr
㽍	tmmvn
㽑	tmmwj
䕢	tmrm
䔅	tmrr
䕱	tmtc
㽐	tmtxc
䔚	tmvb
䒓	tmvs
䔁	tmwd
䓰	tmwg
䔯	tmwr
䖆	tmwv
䓝	tndt
䒱	tnem
䓧	tnem
䕄	tnet
䓮	tnhk
䓿	tniw
䒖	tnj
䒡	tnl
䔺	tnlb
䔖	tnle
䕃	tnli
䔹	tnlo
䔒	tnlr
䔫	tnmb
䕳	tnmb
䒭	tnmi
䕬	tnmm
䔲	tnot
䒳	tnsd
䔡	tnwf
䓲	tocu
䔑	todj
䴆	tohaf
㽔	tohqm
㲫	tohqu
䔀	tohv
㕗	toi
㔮	toibp
䕘	toic
䒫	toip
䓹	toiv
䒨	tok
䓡	tokr
䒗	ton
䔢	toos
㗡	tosp
䔘	toum
㒸	tpho
䓤	tphp
䔛	tpmc
䓒	tpw
䔶	tqao
䔾	tqav
䒹	tqd
䍪	tqdj
䍷	tqdmq
䍶	tqdw
