𪕨	hvhxu
𪕽	hvhye
𧴺	hvic
𪕞	hvice
𥷃	hvid
𥳏	hvii
𥳏	hvik
𪕹	hvilr
𥬓	hvis
𥶝	hvit
𡢛	hviv
𪕏	hvjc
𪖄	hvjdk
𪕎	hvjhn
𪖋	hvjig
𥶜	hvjj
𪕎	hvjlu
𪕱	hvjrb
𪖅	hvjtc
𪔽	hvlbu
𪕕	hvli
𡡓	hvmbc
𪕯	hvmbc
𡤍	hvmhf
𪖍	hvmhm
𪕚	hvmls
𪕀	hvmmu
𥯉	hvmr
𪕲	hvmrw
𪔾	hvmt
𪕣	hvmvm
𥠨	hvnin
𦥓	hvnk
𨙪	hvnl
𨝺	hvnl
𪔼	hvno
𪕆	hvno
𪖆	hvnoe
𤓰	hvo
𪕟	hvoik
𪖎	hvoim
𪕌	hvoin
𣀭	hvok
𪔻	hvok
𪕌	hvomi
𥶫	hvou
𪕛	hvpmr
𪕅	hvpu
𪕾	hvpuu
𪕜	hvrmk
𥰪	hvrq
𥭱	hvrr
𪕰	hvrse
𪕜	hvrvk
𪕝	hvryo
𪔹	hvsh
𪔺	hvshi
𪕔	hvsj
𩑝	hvslc
𪔸	hvsm
𪕠	hvsmf
𣆼	hvst
𠒂	hvsu
𪖊	hvtcd
𪖉	hvtcl
𪖈	hvtco
𪕶	hvtct
𥴘	hvtd
𪕒	hvtt
𥲀	hvvd
𥶢	hvvn
𥷿	hvwf
𡣉	hvwmv
𪕳	hvwp
𪕬	hvybb
𪔿	hvye
𪕇	hvyhn
𪕃	hvyhs
𪕑	hvymp
𪖌	hvypt
𪕐	hvyr
𪖂	hvyub
𣉭	hwa
𥲺	hwaj
𥃝	hwbt
𥭮	hwcb
𠒇	hwcu
𥲢	hwdd
𥀓	hwdhe
𥴞	hwdq
𤐧	hwf
𤐸	hwf
𤓜	hwf
𤓞	hwf
𥡤	hwf
𥷫	hwfr
𥸣	hwfr
𥱽	hwfu
𡍺	hwg
𥳬	hwgf
