駖	sfoii
騐	sfoip
駇	sfok
駈	sfom
駼	sfomd
駩	sfomg
騟	sfomn
驗	sfomo
験	sfomo
騇	sfomr
駞	sfopd
駨	sfpa
馳	sfpd
駜	sfph
馰	sfpi
騘	sfpkp
騊	sfpou
駒	sfpr
騶	sfpuu
騞	sfqjr
駽	sfrb
驒	sfrrj
騢	sfrse
驟	sfseo
驫	sfsff
駋	sfshr
駬	sfsj
駆	sfsk
騽	sfsma
駸	sfsme
驏	sfsnd
駅	sfso
騳	sfsqf
驅	sfsrr	sfs'rr
駏	sfss
駶	sfssr	sfss'r
馵	sft
騲	sftaj
騚	sftbn
驜	sftcd
驧	sftjd
驠	sftlf
騹	sftlm
騏	sftmc
驊	sftmj
驩	sftrg
駢	sftt
騣	sfuce
驨	sfuob
騄	sfvne
駟	sfwc	sfw'c
騍	sfwd
駰	sfwk	sfw'k
驛	sfwlj
騦	sfwp
驆	sfwtj
騾	sfwvf
騯	sfybs
駮	sfyck
驐	sfydk
駐	sfyg
褧	sfyhv
騈	sfyjj
馼	sfyk
驉	sfypc
驉	sfypm
驢	sfypt
驤	sfyrv
騂	sfytj
騿	sfytj
駭	sfyvo
驙	sfywm
鸐	sghaf
戳	sgi
聽	sgjwp
劻	sgks
剭	sgln
邼	sgnl
匵	sgwc	s'gwc
刀	sh
鳲	shaf
鬝	shana
鬜	shanb
鬄	shaph
鬘	shawe
鬅	shbb
髥	shbmm
鬇	shbsd
匴	shbt	s'hbt
刅	shc
鬀	shcnh
鬙	shcwa
髤	shd
鬎	shdbn
鬆	shdci
髲	shdhe
鬎	shdln
髿	shefh
髾	shfb
鬈	shfqu
