敚	xcuok
曽	xcwa
鐹	xcybb
銃	xcyiu
鎄	xcyrv
鏱	xcytj
柦	xdam
櫊	xdanr
枂	xdb
棗	xdbdb
柤	xdbm
枬	xdby
朩	xdc
枩	xdci
棁	xdcru
鬰	xddbu
燓	xddf
壄	xddg
檒	xddhn
榃	xddw
檆	xdffr
槔	xdhaj
梍	xdhap
欅	xdhcq
板	xdhe
栀	xdhmu
杋	xdhni
椼	xdhon
橁	xdhpa
棙	xdhsk
櫷	xdhxu
櫠	xdine
椬	xdjbm
叏	xdje
榢	xdjmo
桡	xdjpu
杕	xdk
鷘	xdkha
朹	xdkn
憖	xdkp
檶	xdksr
柫	xdlln
杠	xdm
欛	xdmbb
樰	xdmbs
梄	xdmcw
柰	xdmmf
橱	xdmmi
枑	xdmvm
槱	xdmwf
朰	xdn
梚	xdnau
桷	xdnbq
杍	xdnd
楺	xdnhd
栁	xdnil
杼	xdnin
椭	xdnlb
杦	xdno
棦	xdnsd
橹	xdnwa
杁	xdo
槜	xdogs
猌	xdoik
梒	xdoir
検	xdomo
枞	xdoo
杺	xdp
栺	xdpa
构	xdpi
楍	xdrrr
櫂	xdsmg
桪	xdsmi
愸	xdsp
赉	xdtbo
様	xdtge
橫	xdtmc
櫗	xdtwi
杣	xdu
梱	xdwd
鶫	xdwha
檛	xdybb
梈	xdyrn
梓	xdytj
槞	xdytu
榱	xdywv
沓	xea
灝	xeafc
渇	xeapp
泿	xeav
滘	xebcr
沉	xebhu
懑	xebp
濉	xebug
覌	xebuu
汃	xec
涚	xecru
瀬	xedlc
漱	xedlo
双	xee
