忍	sip
慰	sip
匾	sisb	s'isb
镼	sisuu
匥	sit	s'it
彠	sitoe
彟	sitoe
褽	siyhv
歰	siymm
耳	sj
肀	sj
臂	sjb
耼	sjbmm
屄	sjc
鐾	sjc
聬	sjcim
聡	sjcip
聪	sjcrp
聁	sjcsh
檗	sjd
取	sje
聂	sjee
郰	sjenl
耿	sjf
糪	sjfd
壁	sjg
聃	sjgb
聐	sjgr
鷿	sjhaf
鵈	sjhaf
聕	sjhgr
聊	sjhhl
聒	sjhjr
聥	sjhlb
毦	sjhqu
聭	sjhui
聛	sjhwj
聰	sjhwp
聣	sjhxu
聀	sji
聝	sjirm
聺	sjjbf
聜	sjjcm
聍	sjjmn
聢	sjjmo
匭	sjjn	s'jjn
聹	sjjpn
聴	sjjwp
屠	sjka
屪	sjkf
耾	sjki
聗	sjkoo
幦	sjlb
耽	sjlbu
聵	sjlmc
聩	sjlmo
聎	sjlmo
刵	sjln
聘	sjlws
顳	sjmbc
聏	sjmbl	sjmb'l
璧	sjmgi
耺	sjmmi
耵	sjmn
礕	sjmr
甓	sjmvn
聇	sjmym
聸	sjncr
孹	sjnd
耶	sjnl
聧	sjnok
聄	sjohh
聆	sjoii
耹	sjoin
聅	sjok
恥	sjp
憵	sjp
聦	sjpkp
擘	sjq
聙	sjqmb
居	sjr
职	sjrc
鼊	sjrxu
躄	sjryo
劈	sjsh
聑	sjsj
聶	sjsjj
联	sjtk
聠	sjtt
耴	sju
聉	sjuu
嬖	sjv
繴	sjvif
聮	sjvif
聫	sjvik
聈	sjvis
聯	sjvit
聨	sjvit
襞	sjyhv
職	sjyia
