釟	xxcc
鈟	xxcnl
兺	xxcsh
慭	xxdkp
杢	xxdm
樮	xxdmw
楃	xxdsm
櫣	xxdyt
檤	xxdyt
汩	xxea
慂	xxebp
沝	xxee
渁	xxeee
汢	xxeg
瀜	xxemb
渥	xxesm
湸	xxeyr
尙	xxfbr
氺	xxff
爕	xxfff
糓	xxgdh
圡	xxgi
殻	xxgnh
垁	xxgok
鷽	xxhbh
笽	xxhbt
劕	xxhcl
穒	xxhdh
夊	xxhe
鴟	xxhih
鷎	xxhjh
翶	xxhjs
鴟	xxhmh
鷎	xxhmh
筇	xxhmn
凩	xxhnd
惥	xxhop
鰴	xxhou
鵅	xxhrh
頶	xxhrm
敋	xxhro
箼	xxhsm
焈	xxhuf
鵚	xxhuh
笜	xxhuu
厸	xxii
庆	xxik
懯	xxikp
栥	xxiod
応	xxip
熋	xxipf
忒	xxipp
鴪	xxjch
廾	xxjj
軕	xxjju
鵍	xxjuh
郩	xxkbn
瘌	xxkdl
夵	xxkf
厺	xxki
乄	xxku
冖	xxln
鳾	xxmbh
鸸	xxmbp
玐	xxmgc
鸖	xxmgh
丟	xxmgi
乛	xxmh
懕	xxmkp
鵶	xxmmh
忈	xxmmp
乁	xxmo
栥	xxmod
堕	xxnbg
勈	xxnbk
阝	xxnl
弜	xxnn
飞	xxno
墬	xxnog
仴	xxob
氽	xxoe
尒	xxof
玍	xxog
舎	xxogr
亽	xxoi
仐	xxoj
儵	xxolh
儵	xxolo
仜	xxom
亇	xxon
伈	xxop
钡	xxopb
钆	xxopu
鵨	xxorh
仭	xxosk
屳	xxou
顈	xxpfm
払	xxqi
抣	xxqpm
唫	xxrc
