𨎮	jjtse
𨍷	jjtsj
𨎝	jjtwa
𨏕	jjtyj
𨏣	jjtyk
𨍈	jjuce
𡩼	jjud
𡪍	jjuf
𨌂	jjumg
𨏳	jjuob
𨏷	jjvff
𨌠	jjvne
𨏋	jjvvd
𨊩	jjvvv
𨌦	jjwhj
𨎟	jjwhr
𨋳	jjwk
𨎅	jjwlm
𨏙	jjwlv
𨍲	jjwmo
𨐁	jjwwm
𨊣	jjy
𨍡	jjyaf
𨌬	jjyaj
𨏂	jjybj
𨏠	jjybp
𨍩	jjybs
𨏅	jjycc
𨍽	jjycv
𨎊	jjycv
𨎎	jjydl
𨌯	jjyib
𨏛	jjyiv
𣁖	jjyk
𨊺	jjylm
𨌳	jjymb
𨎭	jjynv
𨎶	jjypo
𨎙	jjyre
𨏸	jjyrf
𨋤	jjys
𨎡	jjysi
𨏰	jjysj
𨊮	jjysm
𨋢	jjyt
𨍑	jjyta
𨌍	jjytj
𨌶	jjyvu
𨎹	jjywd
𨎺	jjywf
𨏁	jjywk
𡨵	jkam
𧠽	jkbuu
𡨨	jkcn
𡩯	jkcv
𣸗	jke
𤆯	jkf
𪀱	jkhf
𦒷	jkhqu
𩲘	jkhui
𤞮	jkik
𡪐	jkji
𡧑	jkk
𡪋	jkkv
𠩺	jkm
𦒳	jkm
𣘬	jkmd
𠭰	jkme
𥼋	jkmfd
𪅗	jkmhf
𣁛	jkmk
𢄡	jkmlb
𢿂	jkmmj
𦒱	jkmn
𩺸	jkmnf
𢟤	jkmp
𢡷	jkmp
𢿍	jkmye
𣁟	jkmyk
𢿄	jkmym
𡥽	jknd
𡧌	jkne
𡧄	jkni
𡫄	jknk
𦓃	jknmr
𦓆	jknmr
𡧫	jknp
𦙩	jkobo
𩀆	jkog
𢠛	jkp
𢠜	jkp
𣑄	jkpd
𦒶	jkphh
𠲀	jkr
𠺛	jkr
𡧣	jkr
𡧶	jkr
𨝩	jkrau
𨆕	jkryo
𢍛	jkt
