𨒿	ymlw
𨖻	ymlw
𧥛	ymmb
𨕆	ymmb
𩕚	ymmbc
𢍷	ymmht
𢆌	ymmj
𢆒	ymmjj
𣥭	ymmjj
𧇊	ymmjs
𧦂	ymmk
𣥩	ymmmh
𣥿	ymmmh
𨒮	ymmo
𥎼	ymmok
𧨟	ymmr
𣥎	ymmt
𧥜	ymmu
𧘎	ymmv
𧝑	ymmv
𤮆	ymmvn
𤮜	ymmvn
𠧗	ymmy
𧣆	ymnbg
𨑰	ymni
𣥇	ymnj
𣢃	ymno
𣦌	ymnok
𩙼	ymnoo
𧙩	ymnv
𣦇	ymoae
𠅈	ymob
𦙡	ymobo
𨘹	ymoe
𨙆	ymoe
𩁉	ymog
𨔿	ymoj
𥎩	ymok
𣁦	ymomg
𣥐	ymoo
𣦁	ymoo
𣦊	ymooo
𧜍	ymov
𣥰	ymoye
𢗓	ymp
𣥅	ymp
𩑽	ympmc
𨚖	ympnl
𩢑	ympsf
𢪓	ymq
𢮠	ymq
𨗶	ymqc
𣥽	ymqmh
𠮳	ymr
𨒙	ymr
𨖍	ymrj
𣥧	ymrr
𣥴	ymrsh
𧙃	ymrv
𪓼	ymrxu
𠧕	yms
𠝅	ymsh
𨒒	ymsj
𣦠	ymsja
𦒜	ymsmm
𠧛	ymso
𢌱	ymt
𣦡	ymtja
𨘶	ymtp
𣥞	ymtt
𣥟	ymtt
𣦝	ymtwi
𠑷	ymu
𡴃	ymu
𡵩	ymu
𣥃	ymu
𥜾	ymukb
𣥼	ymurr
𨓷	ymvg
𨑼	ymvi
𨕯	ymvi
𣥤	ymw
𨘭	ymwe
𨕅	ymwg
𨗇	ymwi
𨕂	ymwl
𣦐	ymwlm
𣦗	ymwoo
𢛫	ymwp
𨔰	ymwt
𨕞	ymwt
𨗆	ymwu
𨗢	ymwv
𨑜	ymy
𣥹	ymyfe
𨓑	ymyhl
𧇠	ymyhn
𨕭	ymyjj
𣥕	ymylm
𣥖	ymylm
