𨴐	anhgu
𨴅	anhhl
𨴖	anhhv
𨵮	anhjg
𨵞	anhjp
𨷆	anhkm
𨷕	anhme
𨳜	anhml
𨷵	anhml
𨳋	anhn
𨷪	anhoc
𨷋	anhok
𨷣	anhok
𨴠	anhon
𨷥	anhoo
𨵂	anhpb
𨳯	anhq
𨳺	anhqo
𨶇	anhrf
𣅅	anhs
𨴃	anhs
𨶑	anhuk
𨵆	anhvf
𠕣	anhx
𨉖	anhxh
𨵹	anhxt
𨷺	anhxu
𨳮	ani
𨶙	anibp
𨶳	anifu
𨴍	anihq
𨵊	anii
𨴪	anijb
𨵲	anikt
𨶈	anilr
𠕝	anin
𣆚	anin
𨴘	aning
𨴱	aniok
𨴌	anism
𨷭	aniwg
𨷠	aniwg
𨷓	anixf
𨷚	anjac
𨵴	anjbj
𨴥	anjhp
𨳻	anjhu
𨷡	anjim
𨴹	anjkd
𨴵	anjki
𨴛	anjkp
𨵄	anjmu
𣊟	anjo
𨳷	anjp
𨷛	anjpi
𨴣	anjv
𨳓	ank
𨴜	ankb
𨳧	anke
𣉡	ankg
𨴶	ankhh
𨵵	ankit
𨶶	ankja
𣆴	ankm
𨵤	ankmr
𨳊	ankn
𨳾	ankr
𨶬	anlgm
𨷷	anlii
𨵓	anll
𨳭	anlln
𨴡	anlmo
𨵈	anlmy
𨵖	anlp
𨷨	anlpc
𨴁	anlwl
𢑢	anmb
𨷘	anmbb
𨵪	anmbc
𨶛	anmbc
𨴎	anmbl
𨷰	anmbr
𨷏	anmbw
𨴇	anmc
𨳫	anmf
𨴈	anmfm
𨶵	anmgl
𨷦	anmhm
𨴗	anmig
𨳨	anmk
𨷆	anmkm
𨳪	anmlb
𨴉	anmle
𨳎	anmm
𨴂	anmmt
𨵑	anmmu
𨳉	anmo
𨳵	anmob
𨷹	anmof
𨷢	anmof
