𢳧	qile
𢫧	qill
𢷱	qilv
𨠾	qimcw
𢬄	qime
𢫕	qine
𢬠	qine
𢭸	qinn
𦛹	qiobo
𢴜	qion
𢱆	qior
𢱅	qiov
𢩮	qip
𢴧	qipc
𢹲	qipr
𠳆	qir
𨛚	qirau
𢰾	qirp
𢴂	qisb
𢮄	qisd
𢲙	qisv
𢹞	qisv
𢬿	qit
𢱋	qite
𢯪	qitu
𢧬	qiua
𢨢	qiuua
𢺠	qivg
𢷹	qiwg
𢨚	qiwtc
𧚝	qiyhv
𢳡	qjac
𢷤	qjac
𢵋	qjal
𣉄	qjamo
𣍈	qjat
𢸨	qjbd
𢱢	qjbf
𢯕	qjbm
𢷐	qjbo
𢷟	qjbo
𠂴	qjbt
𢲘	qjcc
𢺗	qjcc
𢯱	qjce
𢲼	qjcg
𢰃	qjck
𢱇	qjck
𢲷	qjck
𢭕	qjcn
𢮍	qjcn
𢲁	qjcn
𢱑	qjco
𢳙	qjco
𢭔	qjcp
𢹑	qjct
𢰉	qjcu
𢷈	qjcu
𢳤	qjcv
𢳦	qjcv
𢶺	qjcx
𣐇	qjd
𣓵	qjd
𢬇	qjdi
𡉘	qjg
𠂙	qjh
𠲱	qjher
𢭂	qjhq
𣮝	qjhqu
𢸙	qjhw
𠫢	qji
𢶋	qjig
𢴥	qjip
𢴿	qjjb
𢷦	qjjj
𢺩	qjjj
𢷰	qjjm
𢵕	qjjq
𢮊	qjju
𢭦	qjkd
𢸘	qjkf
𢳩	qjkm
𢰬	qjle
𠛉	qjln
𩑚	qjmbc
𢴍	qjmc
𢺔	qjmc
𧟷	qjmcw
𢮱	qjmf
𢯶	qjmg
𢱱	qjmm
𢴕	qjmn
𧯮	qjmrt
𢴀	qjow
𢰯	qjoy
𢜎	qjp
𢫈	qjr
𢰮	qjrb
𢹷	qjrc
𢰴	qjrk
