𩖛	hnhni
𩙡	hnhnn
𩙠	hnhnu
𥮰	hnho
𩙉	hnhok
𤙲	hnhq
𤜂	hnhq
𣮀	hnhqu
𩗭	hnhsk
𪉍	hnhsm
𩗫	hnhwj
𩘙	hnhwt
𥮛	hnhx
𩘦	hnhxs
𠫗	hni
𩗖	hniav
𩖶	hnid
𩖶	hnijc
𩗕	hnije
𩖮	hnik
𩙥	hnike
𩘜	hnilr
𥭋	hnin
𩖻	hnine
𩖳	hnino
𩗎	hnipm
𥬫	hniq
𩗭	hnisk
𠂗	hniu
𩖭	hnjb
𩗓	hnjbd
𩘝	hnjbf
𩙭	hnjbf
𩘪	hnjcr
𥭰	hnjd
𩘯	hnjii
𥟹	hnjlk
𩗳	hnjlo
𩘰	hnjoa
𩘎	hnjrr
𩘤	hnjwa
𠘰	hnk
𩗉	hnkd
𩖢	hnki
𩗷	hnklu
𩗷	hnklv
𠘪	hnkn
𩘖	hnknn
𥯦	hnkq
𠡩	hnks
𠡸	hnks
𩖙	hnks
𢂨	hnlb
𥳔	hnlb
𥴩	hnlb
𥶻	hnlb
𥶐	hnlc
𥱥	hnld
𥭫	hnlf
𥲎	hnlg
𥶴	hnlg
𥳜	hnlh
𩙨	hnlll
𩖼	hnlln
𥳌	hnlm
𩘺	hnlmc
𠙍	hnlmi
𧊃	hnlmi
𧍢	hnlmi
𩙬	hnlmo
𠞄	hnln
𥲗	hnlo
𥶼	hnlo
𩗻	hnlp
𥳲	hnlt
𩘹	hnlx
𠙒	hnmbc
𩑏	hnmbc
𨡐	hnmcw
𩗢	hnme
𤥔	hnmgi
𢖨	hnmhb
𢆈	hnmhb
𩙖	hnmhm
𥮸	hnmi
𠙗	hnmkv
𥮺	hnml
𩗾	hnmlb
𩗿	hnmlb
𩗠	hnmll
𩗽	hnmlm
𢤉	hnmp
𩘆	hnmrw
𧲔	hnmso
𩗛	hnmso
𣄯	hnmvu
𩘟	hnmwd
𧤊	hnnbg
𡥬	hnnd
𥮜	hnnf
