𩒃	ihmbc
𩒿	ihmbc
𢦹	ihme
𢦡	ihmj
𢎐	ihmmc
𤬹	ihmvn
𢧦	ihmwv
𠘭	ihn
𠘯	ihn
𢦕	ihn
𠫗	ihn
𨝐	ihnl
𠫠	ihnn
𢳅	ihnq
𢊻	ihof
𨿙	ihog
𢧒	ihoir
𢦩	ihoj
𢋋	ihok
𢧒	ihomr
𢊚	ihoo
𢉟	ihov
𢘱	ihp
𢇼	ihpu
𢈹	ihrj
𢉞	ihsb
𣒷	ihsd
𢦓	ihsh
𢧿	ihslb
𢉐	ihuf
𢋛	ihul
𢈣	ihwe
𢈣	ihwn
𢊕	ihwp
𢌉	ihxe
𢈯	ihxh
𥂒	ihxt
𢿈	ihye
𢊀	ihyn
𢊐	ihyo
𨐳	ihytj
𢊀	ihyu
𪁜	iiahf
𠬋	iiahm
𢈋	iib
𧶤	iibc
𨋿	iibjj
𠬂	iibnq
𠘦	iibt
𥆴	iibu
𧴵	iibuc
𢈡	iice
𢦬	iie
𡢜	iifv
𡋊	iig
𪂑	iihaf
𣂧	iihml
𠫞	iihn
𠫨	iihni
𤜘	iihq
𢇰	iihu
𩳠	iihui
𠁼	iii
𢈽	iii
𧵱	iiic
𠬁	iiig
𠫬	iiii
𠫸	iiil
𠫼	iiil
𠬐	iiil
𠬔	iiil
𠬘	iiil
𧏝	iiil
𠫰	iiim
𠬄	iiim
𠬅	iiim
𤯢	iiim
𠬔	iiin
𠫯	iiio
𠫫	iiis
𠫱	iiiu
𠬎	iiiv
𤲛	iiiw
𢈝	iije
𢩍	iijr
𢊹	iikc
𢇷	iike
𢊯	iikf
𢇷	iikk
𥚪	iill
𢨁	iilm
𠒊	iilu
𠙃	iimn
𣩇	iimnp
𦫍	iimt
𤭒	iimvn
𨝧	iinl
𨿽	iiog
𢈟	iiok
𢾭	iiok
