裫	llxl
牓	llybs
丄	lm
袹	lma
襦	lmbb
袻	lmbl	lmb'l
贵	lmbo
貴	lmbuc
衧	lmd
襧	lmfb
賮	lmfbc
盡	lmfbt
壮	lmg
虫	lmi
状	lmik
衦	lmj
裲	lmlb
劃	lmln
襹	lmmp
兠	lmmu
裖	lmmv
将	lmnii
袔	lmnr
北	lmp
邶	lmpnl
袥	lmr
裋	lmrt
褔	lmrw
非	lmsy
剕	lmsyn
兆	lmuo
頫	lmuoc
鴵	lmuof
覜	lmuou
妆	lmv
褥	lmvi
褾	lmwf
褼	lmwu
卝	lmy
鬥	ln
刂	ln
冖	ln
襐	lnao
鬬	lnbml
费	lnbo
費	lnbuc
覑	lnbuu
襜	lncr
桨	lnd
浆	lne
牉	lnfq
牘	lngwc
衱	lnhe
版	lnhe
牐	lnhjx
牖	lnhsb
牑	lnhsb
牌	lnhwj
牕	lnhwp
鬩	lnhxu
鬮	lnhxu
牔	lnibi
襁	lnii
牋	lnii
牗	lnilb
袳	lnin
牖	lnisb
牑	lnisb
牍	lnjnk
奖	lnk
刜	lnln
酱	lnmcw
鬫	lnmjk
鬪	lnmti
艴	lnnau
鬫	lnnjk
鬮	lnnxu
襏	lnoe
牏	lnomn
牎	lnpkp
牒	lnptd
襁	lnri
鬭	lnrml
牊	lnshr
鬨	lntc
牓	lnybs
鬦	lnyj
鬧	lnylb
複	loae
衲	lob
袝	lodi
袮	lof
襍	logd
鼗	logte
袵	lohg
袗	lohh
袊	loii
袱	loik
襳	loim
衿	loin
