𡮂	fhaf
𩾟	fhaf
𤋡	fhak
𤈥	fhap
𤏔	fhar
𤒎	fhbd
𡮑	fhbdu
𤒪	fhbi
𡭸	fhbmr
𤈍	fhbr
𤏓	fhbs
𤒅	fhbu
𤎑	fhce
𤋭	fhda
𤏨	fhdb
𤊔	fhdl
𤎕	fhdp
𤉦	fhdv
𠬵	fhe
𤇺	fheq
𡭝	fhf
𡮏	fhfhh
𢒮	fhhah
𤑬	fhhe
𣪼	fhhne
𤐎	fhia
𤇮	fhio
𤈐	fhjd
𤈏	fhjr
𤊿	fhjx
𡙢	fhk
𡭟	fhk
𧏟	fhli
𠚺	fhln
𤏫	fhlq
𡭺	fhmb
𩔫	fhmbc
𤇚	fhmy
𤆘	fhni
𩖟	fhni
𨙹	fhnl
𣢒	fhno
𩵮	fhnwf
𤈧	fhoe
𡮌	fhoe
𤋵	fhoi
𢿦	fhok
𢿽	fhok
𤑈	fhok
𤍡	fhop
𤏧	fhor
𦐶	fhosm
𤊵	fhpl
𤈯	fhpo
𤇣	fhqm
𨚈	fhrau
𨚒	fhrau
𤍦	fhsb
𤒟	fhsc
𤑕	fhsf
𤑛	fhsf
𤒘	fhsf
𦕉	fhsj
𤆡	fhsm
𤆭	fht
𡮹	fhtbo
𤓎	fhuc
𤌼	fhug
𤌋	fhui
𡭲	fhuu
𤆟	fhv
𡮀	fhwcb
𨤢	fhwg
𤑉	fhxc
𤑍	fhxc
𤒾	fhxf
𤊓	fhxu
𪚯	fhxu
𪚱	fhxu
𥅷	fhybu
𡮯	fhyhr
𤆓	fi
𤇖	fibm
𤌶	fibp
𡮚	fibr
𤉜	fid
𤎎	fidd
𤓒	fidy
𤐠	fife
𤍄	fifm
𤇦	fih
𤇳	fihm
𤎜	fiib
𤍜	fiih
𤍎	fiil
𤏟	fiip
𤐒	fiit
𤇽	fij
𤇭	fikp
𠢁	fiks
