孃	vyrv
嫙	vyso
媫	vyso
媇	vytd
嫜	vytj
嬘	vyto
嬑	vytp
婄	vytr
妶	vyvi
姟	vyvo
嬗	vywm
田	w
畼	wamh
胃	wb
朙	wbb
畳	wbbm
顒	wbmbc
颙	wbmbo
愚	wbp
四	wc	w'c
囧	wcb	w'cb
囶	wcg	w'cg
鷶	wchaf
畟	wche
圙	wcmw	w'cmw
圀	wcys	w'cys
果	wd
困	wd	w'd
团	wdh	w'dh
褁	wdhv
団	wdi	w'di
顆	wdmbc
颗	wdmbo
圍	wdmq	w'dmq
夥	wdnin
敤	wdye
囦	we	w'e
畷	weee
疄	wfdq
黠	wfgr
黷	wfgwc
黢	wfice
黬	wfihr
黲	wfiih
默	wfik
黪	wfikh
黓	wfip
黰	wfjbc
黩	wfjnk
黦	wfjnu
黤	wfklu
黕	wflbu
黖	wfmvu
黫	wfmwg
黵	wfncr
黟	wfnin
黔	wfoin
黭	wfort
黣	wfowy
黗	wfpu
畔	wfq
畻	wfqg
圈	wfqu	w'fqu
圏	wfqu	w'fqu
黚	wftm
黮	wftmv
黜	wfuu
黝	wfvis
黸	wfypt
點	wfyr
黥	wfyrf
黯	wfyta
里	wg
畘	wgb
畤	wgdi
黑	wgf
黒	wgf
墨	wgfg
畦	wgg
圔	wgit	w'git
疇	wgni
野	wgnin
園	wgrv	w'grv
圉	wgtj	w'gtj
鴫	whaf
囷	whd	w'hd
畈	whe
略	wher
畧	wher
图	whey	w'hey
畽	whjg
畖	whvo
囜	wi	w'i
圎	wibc	w'ibc
圑	wibi	w'ibi
畯	wice
鸀	wihaf
圃	wijb	w'ijb
圗	wijw	w'ijw
畎	wik
